R      1024 768
NO ./textures/pink_shulker_box.xpm
SO ./textures/mossy_stone_bricks.xpm
WE ./textures/debug.xpm
EA ./textures/granite.xpm
S    ./textures/barrel.xpm
F 188, 143, 143          
C 176, 224, 233     

        1111111111111111111111111
        1000000000110000000000001
        1000000001110002000000001
        1001000000000000000000001
111111111011000001110000022222201
100000000011000221110000111111111
11110111111111011100000010001
11110111111111011101010010001
11002211010101110000000002201
10000000000000001100000000001
10002200000000001101010010001
11200001110101011101111N00111
11112111 1110101 101111010001
11111111 1111111 111111111111

